


1111111111111
100100C0000C1
1C00011111001
100011E000001
100100C0000C1
100100C000001
1001000111101
1001001100101
10010010C0101
1001001100001
100100P010001
1111111111111
