11111111
1C0000C1
11011001
11011001
11011001
11011001
11011001
110110C1
1E000001
111110P1
1C000001
10000001
11011001
11011001
11011001
10000001
11011001
11011001
11011001
11011001
11011001
11011001
11011001
11011001
11011001
11011001
11011001
11011001
11011001
11011001
11011001
11011001
11011001
11011001
11011001
11011001
11011001
11011001
11011001
11011001
11111111
